####################
#..................#
#.################.#
#..................#
#.#.###.###.####.#.#
#..................#
#.################.#
#..................#
####################

