####################
#..................#
#.################.#
#.#..............#.#
#.#.############.#.#
#.#..............#.#
#.################.#
#..................#
####################

